1111111111
1P000C0001
10001C0001
10000C0001
10000C0001
10000C0001
10000C00E1
1111111111